TTTTTTTTTTTTTTTTTT
T             P  T
T         R      T
T       R        T
T                D
T            P   T
T          T     T
T P              T
TTTTTTTTTTTTTTTTTT