TTTTTTTTTTTTTTTTTT
T TTT RP      P  T
T  T  T   RP  R  T
TP      R    P   T
TP      P     P  D
T       P    P   T
T   T  P  RT     T
T P    TT    PPR T
TTTTTTTTTTTTTTTTTT