TTTTTTTTTTTTTTTTTT
T T RP   P       T
T  T   P  RP PRR T
TP  R   R  P  R  T
TP   TP PP RP P  D
T   RR  P  T  PTPT
T   T  P  PT PTR T
T P    TR     T RT
TTTTTTTTTTTTTTTTTT